1;1;1;1;1;1;1;1;1;1;1;1;1;1;1;1;1;1;1;1;1;1;1;1;1;1;1;1;1;1;1;1;1;1;1;1;1;1;1;1;1;1;1;1;1;1;1;1;1;1;1;1
1;4;4;4;4;4;4;4;4;4;4;4;4;4;4;4;4;4;4;4;4;4;1;0;0;0;0;1;1;1;4;4;4;4;4;4;4;4;4;4;4;4;4;4;4;4;4;4;4;4;4;1
1;4;4;4;4;4;4;4;4;4;4;4;4;4;4;4;4;4;4;4;4;4;1;0;0;8;0;0;0;1;4;4;4;4;4;4;4;4;4;4;4;4;4;4;4;4;4;4;4;4;4;1
1;4;4;4;4;4;4;4;4;4;4;4;4;4;4;4;4;4;4;4;4;4;1;0;0;0;0;1;0;1;4;4;4;4;4;4;4;4;4;4;4;4;4;4;4;4;4;4;4;4;4;1
1;4;4;4;4;4;4;4;4;4;4;4;4;4;4;4;4;4;4;4;4;4;1;0;0;0;0;1;0;1;4;4;4;4;4;4;4;4;4;4;4;4;4;4;4;4;4;4;4;4;4;1
1;4;4;4;4;4;4;4;4;4;4;4;4;4;4;4;4;4;4;4;4;4;1;0;0;0;0;1;0;1;4;4;4;4;4;4;4;4;4;4;4;4;4;4;4;4;4;4;4;4;4;1
1;4;4;4;4;4;4;4;4;4;4;4;4;4;4;4;4;4;4;4;4;4;1;0;0;0;0;1;0;1;4;4;4;4;4;4;4;4;4;4;4;4;4;4;4;4;4;4;4;4;4;1
1;4;4;4;4;4;4;4;4;4;4;4;4;4;4;4;4;4;4;4;4;4;1;0;0;0;0;1;0;1;4;4;4;4;4;4;4;4;4;4;4;4;4;4;4;4;4;4;4;4;4;1
1;4;4;4;4;4;4;4;4;4;4;4;4;4;4;4;4;4;4;4;4;4;1;0;0;0;0;1;0;1;4;4;4;4;4;4;4;4;4;4;4;4;4;4;4;4;4;4;4;4;4;1
1;4;4;4;4;4;4;4;4;4;4;4;4;4;4;4;4;4;4;4;4;4;1;0;0;0;0;1;0;1;4;4;4;4;4;4;4;4;4;4;4;4;4;4;4;4;4;4;4;4;4;1
1;4;4;4;4;4;4;4;4;4;4;4;4;4;4;4;4;4;4;4;4;4;1;0;0;0;0;1;0;1;4;4;4;4;4;4;4;4;4;4;4;4;4;4;4;4;4;4;4;4;4;1
1;4;4;4;4;4;4;4;4;4;4;4;4;4;4;4;4;4;4;4;4;4;1;0;0;0;0;1;0;1;4;4;4;4;4;4;4;4;4;4;4;4;4;4;4;4;4;4;4;4;4;1
1;4;4;4;4;4;4;4;4;4;4;4;4;4;4;4;4;4;4;4;4;4;1;0;0;0;0;1;0;1;4;4;4;4;4;4;4;4;4;4;4;4;4;4;4;4;4;4;4;4;4;1
1;4;4;4;4;4;4;4;4;4;4;4;4;4;4;4;4;4;4;4;4;4;1;0;0;0;0;1;0;1;4;4;4;4;4;4;4;4;4;4;4;4;4;4;4;4;4;4;4;4;4;1
1;4;4;4;4;4;4;4;4;4;4;4;4;4;4;4;4;4;4;4;4;4;1;0;0;0;0;1;0;1;4;4;4;4;4;4;4;4;4;4;4;4;4;4;4;4;4;4;4;4;4;1
1;4;4;4;4;4;4;4;4;1;1;1;1;1;1;1;1;1;1;1;1;1;1;0;0;0;0;1;0;1;1;1;1;1;1;1;1;1;1;1;1;4;4;4;4;4;4;4;4;4;4;1
1;4;4;4;4;4;4;4;4;1;0;0;0;0;0;0;0;0;0;0;1;1;1;0;0;0;0;1;0;1;0;0;0;0;0;0;0;0;0;0;1;4;4;4;4;4;4;4;4;4;4;1
1;4;4;4;4;4;4;4;4;1;0;1;1;1;1;1;1;1;1;0;1;1;1;0;0;0;0;1;0;1;0;1;1;1;1;1;1;1;1;0;1;4;4;4;4;4;4;4;4;4;4;1
1;4;4;4;4;4;4;4;4;1;0;1;1;1;1;1;1;1;1;0;1;1;1;3;3;3;3;1;0;1;0;1;1;1;1;1;1;1;1;0;1;4;4;4;4;4;4;4;4;4;4;1
1;4;4;4;4;4;4;4;4;1;0;1;1;0;0;0;0;0;0;0;0;0;0;0;0;0;0;0;0;5;0;0;0;0;0;0;0;1;1;0;1;4;4;4;4;4;4;4;4;4;4;1
1;4;4;4;4;4;4;4;4;1;0;1;1;0;0;0;0;0;0;0;0;0;0;0;0;0;0;0;0;0;0;0;0;0;0;0;0;1;1;0;1;4;4;4;4;4;4;4;4;4;4;1
1;4;4;4;4;4;4;4;4;1;0;1;1;0;0;0;0;0;0;0;0;0;0;0;0;0;0;0;0;0;0;0;0;0;0;0;0;1;1;0;1;4;4;4;4;4;4;4;4;4;4;1
1;4;4;4;4;4;4;4;4;1;0;1;1;0;0;0;0;0;0;0;0;3;3;0;0;0;0;3;3;0;0;0;0;0;0;0;0;1;1;0;1;4;4;4;4;4;4;4;4;4;4;1
1;4;4;4;4;4;4;4;4;1;0;1;1;0;0;0;0;0;0;0;0;0;0;0;0;0;0;0;0;0;0;0;0;0;0;0;0;1;1;0;1;4;4;4;4;4;4;4;4;4;4;1
1;4;4;4;4;4;4;4;4;1;0;1;1;0;0;0;0;0;0;0;0;0;0;0;2;2;5;0;0;0;0;0;0;0;0;0;0;1;1;0;1;4;4;4;4;4;4;4;4;4;4;1
1;4;4;4;4;4;4;4;4;1;0;1;1;0;0;0;0;0;0;0;0;0;0;0;2;2;0;0;0;0;0;0;0;0;0;0;0;1;1;0;1;4;4;4;4;4;4;4;4;4;4;1
1;4;4;4;4;4;4;4;4;1;0;1;1;0;0;0;0;0;0;0;0;0;0;0;0;0;0;0;0;0;0;0;0;0;0;0;0;1;1;0;1;4;4;4;4;4;4;4;4;4;4;1
1;4;4;4;4;4;4;4;4;1;0;1;1;0;0;0;0;0;0;0;0;3;3;0;0;0;0;3;3;0;0;0;0;0;0;0;0;1;1;0;1;4;4;4;4;4;4;4;4;4;4;1
1;4;4;4;4;4;4;4;4;1;0;1;1;0;0;0;0;0;0;0;0;0;0;0;0;0;0;0;0;0;0;0;0;0;0;0;0;1;1;0;1;4;4;4;4;4;4;4;4;4;4;1
1;4;4;4;4;4;4;4;4;1;0;1;1;0;0;0;0;0;0;0;0;0;0;0;0;0;0;0;0;0;0;0;0;0;0;0;0;1;1;0;1;4;4;4;4;4;4;4;4;4;4;1
1;4;4;4;4;4;4;4;4;1;0;1;1;0;0;0;0;0;0;0;5;0;0;0;0;0;0;0;0;0;0;0;0;0;0;0;0;1;1;0;1;4;4;4;4;4;4;4;4;4;4;1
1;4;4;4;4;4;4;4;4;1;0;1;1;1;1;1;1;1;1;0;1;0;1;3;3;3;3;1;1;1;0;1;1;1;1;1;1;1;1;0;1;4;4;4;4;4;4;4;4;4;4;1
1;4;4;4;4;4;4;4;4;1;0;1;1;1;1;1;1;1;1;0;1;0;1;0;0;0;0;1;1;1;0;1;1;1;1;1;1;1;1;0;1;4;4;4;4;4;4;4;4;4;4;1
1;4;4;4;4;4;4;4;4;1;0;0;0;0;0;0;0;0;0;0;1;0;1;0;0;0;0;1;1;1;0;0;0;0;0;0;0;0;0;0;1;4;4;4;4;4;4;4;4;4;4;1
1;4;4;4;4;4;4;4;4;1;1;1;1;1;1;1;1;1;1;1;1;0;1;0;0;0;0;1;1;1;1;1;1;1;1;1;1;1;1;1;1;4;4;4;4;4;4;4;4;4;4;1
1;4;4;4;4;4;4;4;4;4;4;4;4;4;4;4;4;4;4;4;1;0;1;0;0;0;0;1;4;4;4;4;4;4;4;4;4;4;4;4;4;4;4;4;4;4;4;4;4;4;4;1
1;4;4;4;4;4;4;4;4;4;4;4;4;4;4;4;4;4;4;4;1;0;1;0;0;0;0;1;4;4;4;4;4;4;4;4;4;4;4;4;4;4;4;4;4;4;4;4;4;4;4;1
1;4;4;4;4;4;4;4;4;4;4;4;4;4;4;4;4;4;4;4;1;0;1;0;0;0;0;1;4;4;4;4;4;4;4;4;4;4;4;4;4;4;4;4;4;4;4;4;4;4;4;1
1;4;4;4;4;4;4;4;4;4;4;4;4;4;4;4;4;4;4;4;1;0;1;0;0;0;0;1;4;4;4;4;4;4;4;4;4;4;4;4;4;4;4;4;4;4;4;4;4;4;4;1
1;4;4;4;4;4;4;4;4;4;4;4;4;4;4;4;4;4;4;4;1;0;1;0;0;0;0;1;4;4;4;4;4;4;4;4;4;4;4;4;4;4;4;4;4;4;4;4;4;4;4;1
1;4;4;4;4;4;4;4;4;4;4;4;4;4;4;4;4;4;4;4;1;0;1;0;0;0;0;1;4;4;4;4;4;4;4;4;4;4;4;4;4;4;4;4;4;4;4;4;4;4;4;1
1;4;4;4;4;4;4;4;4;4;4;4;4;4;4;4;4;4;4;4;1;0;1;0;0;0;0;1;4;4;4;4;4;4;4;4;4;4;4;4;4;4;4;4;4;4;4;4;4;4;4;1
1;4;4;4;4;4;4;4;4;4;4;4;4;4;4;4;4;4;4;4;1;0;1;0;0;0;0;1;4;4;4;4;4;4;4;4;4;4;4;4;4;4;4;4;4;4;4;4;4;4;4;1
1;4;4;4;4;4;4;4;4;4;4;4;4;4;4;4;4;4;4;4;1;0;1;0;0;0;0;1;4;4;4;4;4;4;4;4;4;4;4;4;4;4;4;4;4;4;4;4;4;4;4;1
1;4;4;4;4;4;4;4;4;4;4;4;4;4;4;4;4;4;4;4;1;0;1;0;0;0;0;1;4;4;4;4;4;4;4;4;4;4;4;4;4;4;4;4;4;4;4;4;4;4;4;1
1;4;4;4;4;4;4;4;4;4;4;4;4;4;4;4;4;4;4;4;1;0;1;0;0;0;0;1;4;4;4;4;4;4;4;4;4;4;4;4;4;4;4;4;4;4;4;4;4;4;4;1
1;4;4;4;4;4;4;4;4;4;4;4;4;4;4;4;4;4;4;4;1;0;1;0;0;0;0;1;4;4;4;4;4;4;4;4;4;4;4;4;4;4;4;4;4;4;4;4;4;4;4;1
1;4;4;4;4;4;4;4;4;4;4;4;4;4;4;4;4;4;4;4;1;0;1;0;0;0;0;1;4;4;4;4;4;4;4;4;4;4;4;4;4;4;4;4;4;4;4;4;4;4;4;1
1;4;4;4;4;4;4;4;4;4;4;4;4;4;4;4;4;4;4;4;1;0;1;0;0;0;0;1;4;4;4;4;4;4;4;4;4;4;4;4;4;4;4;4;4;4;4;4;4;4;4;1
1;4;4;4;4;4;4;4;4;4;4;4;4;4;4;4;4;4;4;4;1;0;0;0;0;7;0;1;4;4;4;4;4;4;4;4;4;4;4;4;4;4;4;4;4;4;4;4;4;4;4;1
1;4;4;4;4;4;4;4;4;4;4;4;4;4;4;4;4;4;4;4;1;1;1;0;0;0;0;1;4;4;4;4;4;4;4;4;4;4;4;4;4;4;4;4;4;4;4;4;4;4;4;1
1;1;1;1;1;1;1;1;1;1;1;1;1;1;1;1;1;1;1;1;1;1;1;1;1;1;1;1;1;1;1;1;1;1;1;1;1;1;1;1;1;1;1;1;1;1;1;1;1;1;1;1
